111111111111111111111111111111111111
1E0011100100010000010000010000001001
1C1101010111111010100100000101010001
1C1001001CCCC0100010010000000101P001
1C0100101C11C1100000000000011001C001
1C1011010C11C0110000000000110001C001
1C0010001C11C0111000000001100011C001
1C0100010C11C0101100000011001101C001
1C0010100C11C0100110000110011001C001
1C1001000C11C0101011001100110001C001
1C0010000C11C0001001111001100001C001
1C0100100C11C0010000110000000001C001
1C1001010C11C0100001111000000011C001
1C0100000C11C0100011001100000101C001
1C0100101C11C0100110000110000101C001
1C0010010C11C0101100000011101111C001
1C1101001C11C1111000000001111011C001
1C0110110C11C0110000000000110001C001
1CCCCCCCCC11CCCCCCCCCCCCCCCCCCCCC001
111111111111111111111111111111111111