1111111111111
10C01000010E1
100010C001C01
100C1000C1101
1000C00000001
10C0000C000P1
1111111111111